

2211111114
1122111111
1111221111
1111112211
4111111122