


9991111999
9111111119
9111991119
9111111119
9991111999